1, 0, 1, 1, 3, 2, 3, 9, 3, 1, 2, 3
2, 1, 1, 2, 4, 2, 2, -1, 4, 2, 2, 0
-1, -1, -1, -1, -1, 5, 3, -1, 2, -1, 3, 2
3, 9, 1, 3, 9, 3, 5, -1, 1, -1, 2, 2,
2, 2, -1, -1, -1, -1, -1, -1, 2, -1, 3, 6
3, 3, -1, 0, 2, 4, 6, 1, 2, -1, 7, 0
4, 2, -1, 2, 3, -1, -1, -1, 2, -1, 2, 2
4, 2, -1, 2, 3, -1, -1, -1, 2, 1, 2, 2
2, 1, 9, 2, 4, 2, 2, 1, 4, 2, 2, 0
-1, -1, -1, 2, 3, -1, 4, 3, -1, -1, 3, 1
3, 5, 6, 2, 3, -1, 2, 3, -1, -1, 5, 1
5, 6, 7, 2, 1, -1, 4, 3, -1, -1, 3, 1